Flexeril=Cyclobenzaprine
Robaxin=Methocarbamol
Soma=Carisoprodol
Zanaflex=Tizanidine
Celebrex=Celecoxib
Mobic=Meloxicam
Motrin=Ibuprofen
Naprosyn=Naproxen
Anaprox=Naproxen Sodium
Voltaren, Voltaren XR=Diclofenac Sodium
Duragesic=Fentanyl (Patch)
Norco, Vicodin=Hydrocodone / Acetaminophen (APAP)
OxyContin=Oxycodone CR
Percocet=Oxycodone / APAP
Tylenol with Codeine=Codeine / APAP
Lidoderm=Lidocaine (Patch)
Ultram, Ultram ER=Tramadol
Ultracet=Tramadol /APAP
Ceftin=Cefuroxime
Keflex=Cephalexin
Omnicef=Cefdinir
Biaxin, Biaxin XL=Clarithromycin
Ery-Tab=Erythromycin
Zithromax, Z-Pak, Tri-Pak (Ophth: AzaSite)=Azithromycin
Amoxil=Amoxicillin
Augmentin=Amoxicillin +Clavulanate
Principen=Ampicillin
Veetids=Penicillin VK
Avelox(Ophth: Vigamox, Moxeza)=Moxifloxacin
Cipro=Ciprofloxacin
OTIC: CiproDex=Ciprofloxacin + Dexamethasone
Levaquin (Ophth: Quixin)=Levofloxacin
Minocin, Dynacin=Minocycline
Vibramycin=Doxycycline Hyclate
Bactrim (Septra), Bactrim DS, (Septra DS)=Sulfamethoxazole + Trimethoprim
Cleocin=Clindamycin
Flagyl=Metronidazole
Macrobid=Nitrofurantoin
Diflucan=Fluconazole
Mycostatin=Nystatin
Valtrex=Valacyclovir
Crestor=Rosuvastatin
Lescol, Lescol XL=Fluvastatin
Lipitor=Atorvastatin
Livalo=Pitavastatin
Mevacor=Lovastatin
Pravachol=Pravastatin
Zocor=Simvastatin
Lopid=Gemfibrozil
Lovaza (Fish Oil)=Omega-3-acid Ethyl Esters
Niaspan (Vitamin B1)=Niacin
Questran=Cholestyramine Resin
TriCor=Fenofibrate
Vascepa (Fish Oil)=Icosapent Ethyl
Welchol=Colesevelam
Zetia=Ezetimibe
Vytorin=Ezetimibe + Simvastatin
Accupril=Quinapril
Altace=Ramipril
Capoten=Captopril
Lotensin=Benazepril
Vasotec=Enalapril
Zestril, Prinivil=Lisinopril
Zestoretic, Prinzide=Lisinopril + Hydrochlorothiazide (HCTZ)
Avapro=Irbesartan
Avalide=Irbesartan + Hydrochlorothiazide (HCTZ)
Benicar=Olmesartan
Cozaar=Losartan
Hyzaar=Losartan + Hydrochlorothiazide (HCTZ)
Diovan=Valsartan
Diovan HCT=Valsartan + Hydrochlorothiazide (HCTZ)
Edarbi=Azilsartan
Bystolic=Nebivolol
Coreg, Coreg CR=Carvedilol
Lopressor=Metoprolol Tartrate
Toprol-XL=Metoprolol Succinate
Tenormin=Atenolol
Zebeta=Bisoprolol
Norvasc=Amlodipine
Lotrel=Amlodipine + Benazepril
Plendil=Felodipine ER
Procardia XL, Nifedical XL=Nifedipine ER
Calan, Calan SR, Verelan=Verapamil
Cardizem CD=Diltiazem ER
Aldactone=Spironolactone
Lasix=Furosemide
Microzide=Hydrochlorothiazide (HCTZ)
Dyazide, Maxzide=Triamterene + HCTZ
Apresoline=Hydralazine
Catapres, Catapres-TTS=Clonidine Hydrochloride
Ziac=Bisoprolol + HCTZ
Imdur ER, Isordil = Isosorbide Mononitrate, Isosorbide Dinitrate
Nitrostat (Sublingual)=Nitroglycerin
Klor-Con, K-Dur, Micro-K=Potassium Chloride
Lanoxin, Digitek=Digoxin
Plavix=Clopidogrel Bisulfate
Coumadin, Jantoven=Warfarin
Eliquis=Apixaban
Pradaxa=Dabigatran
Xarelto=Rivaroxaban
Lovenox=Enoxaparin
Alesse, Aviane, Portia=Levonorgestrel + Ethinyl Estradiol (monophasic) 
Ocella, Yasmin, Zarah, Syeda=Drospirenone + Ethinyl Estradiol
Ortho-Cyclen, Sprintec, Ortho Tri-Cyclen, TriSprintec, Trinessa=Norgestimate + Ethinyl Estradiol
Yasmin, Zarah, Syeda, Ocella=Drospirenone + Ethinyl Estradiol
Apidra=Insulin Glulisine
Humalog=Insulin Lispro
Novolog=Insulin Aspart
Lantus, Toujeo=Insulin Glargine
Levemir=Insulin Detemir
Byetta=	Exenatide  
Actos=Pioglitazone
Amaryl=Glimepiride
DiaBeta, Glynase=Glyburide
Glucovance=Glyburide + Metformin
Glucophage=Metformin
Glucotrol=Glipizide
Januvia=Sitagliptin
Colcrys=Cholcine
Zyloprim=Allopurinol
Actonel=Risedronate
Boniva=Ibandronate
Fosamax=Alendronate
Synthroid, Levoxyl=Levothyroxine
Evista=Raloxifene
Folvite=Folic Acid
Premarin=Conjugated Equine Estrogens (CEE)
Decadron, DexPak=Dexamethasone
Medrol, Medrol DosePak=Methylprednisolone
Aciphex=Rabeprazole
Nexium=Esomeprazole (OTC 20mg, Rx 40mg)
Prevacid=Lansoprazole (OTC 15mg, Rx 30mg)
Prilosec=Omeprazole (OTC 20mg, Rx 10mg, 40mg)
Protonix=Pantoprazole 
Pepcid=Famotidine (OTC 10mg, 20mg, Rx 40mg)
Zantac=Ranitidine (OTC 75mg, 150mg, Rx 300 mg)
Phenergan=Promethazine
Reglan=Metoclopramide
Aricept=Donepezil
Namenda, Namenda XR=Memantine
Sinemet=Carbidopa/Levodopa
Fioricet=Butalbital, Acetaminophen (APAP), Caffeine
Imitrex=Sumatriptan
Maxalt, Maxalt-MLT=Rizatriptan
Lamictal=Lamotrigine
Lyrica=Pregabalin
Neurontin=Gabapentin
Tegretol, Tegretol XR=Carbamazepine
Ambien, Ambien CR=Zolpidem
Ativan=Lorazepam
Klonopin=Clonazepam 
Lunesta=Eszopiclone
Restoril=Temazepam
Valium=Diazepam
Xanax=Alprazolam
Depakote, Depakote ER=Divalproex Sodium
Eskalith=Lithium Carbonate
Cymbalta=Duloxetine
Effexor, Effexor XR=Venlafaxine
Celexa=Citalopram
Lexapro=Escitalopram
Paxil, Paxil CR=Paroxetine
Prozac, Prozac Weekly=Fluoxetine
Zoloft=Sertraline
Desyrel=Trazodone
Elavil=Amitriptyline
Wellburtin, Wellbutrin XL, Wellbutrin SR, Zyban (Smoking Cessation)=Bupropion
Abilify=Aripiprazole
Geodon=Ziprasidone
Risperdal=Risperidone
Saphris=Asenapine
Seroquel, Seroquel XR=Quetiapine
Zyprexa=Olanzapine
Adderall, Adderall XR=Dextroamphetamine / Amphetamine
Concerta, Ritalin, Methylin, Metadate ER, Metadate CD, Daytrana, QuilliChew ER, Quillivant XR=Methylphenidate
Focalin XR=Dexmethylphenidate
Vyvanse=Lisdexamfetamine
Flovent=Fluticasone
Advair HFA, Advair Diskus=Fluticasone + Salmeterol
Pulmicort=Budesonide
Symbicort=Budesonide + Formoterol
Proventil, AccuNeb=Albuterol
Xopenex=Levalbuterol
Atrovent=Ipratropium
Combivent, DuoNeb=Ipratropium + Albuterol
Singulair=Montelukast
Spiriva=Tiotropium
Avodart=Dutasteride
Cardura, Cardura XL=Doxazosin
Flomax=Tamsulosin
Hytrin=Terazosin
Proscar=Finasteride
Cialis=Tadalafil
Levitra, Staxyn=Vardenafil
Viagra=Sildenafil
Detrol, Detrol LA=Tolterodine
Ditropan, Ditropan XL=Oxybutynin
Vesicare=Solifenacin
Pataday, Patanol, Pazeo=Olopatadine
Xalatan=Latanoprost
EOF